11111
1P0E1
10001
1C101
11111
