1111111111111
10C000010X001
100C0001100V1
100P000010001
1000000000001
10000000V0001
1111100000001
100E000C00C01
1111111111111