1111111111111111111111111111
10C000010X000000010000000001
100C0001100V0000010000000001
100P000010000000010000C00001
10000000000000C00100000X0001
1111100000111110010000000001
1111100000000000010000000V01
1C00000000000V00001111000001
11C0000000000000000000000V01
1111100001111111111111000001
11111000000000111C00000X0001
1111100000000000000000000001
100E000C00C00000000000C00001
1111111111111111111111111111