11111
1P1E1
10001
10C01
11111
