1111111111111
10C0000100001
100C000110001
100P000011111
1000000000001
1000000000001
1111100000001
100E000C00C01
1111111111111